Student ID,Moral Studies,English,Science,Maths,History,Geograpgy,Total,Url Links
001,65,10,59,3,71,37,245,https://example.com/results/001 
002,94,56,4,67,91,50,362,https://example.com/results/002
003,7,85,76,99,60,25,352,
004,88,46,59,94,52,38,377,
005,39,81,37,38,6,54,255,
006,51,43,14,53,64,59,284,
007,73,48,6,38,50,21,236,
008,18,23,97,65,15,20,238,
009,15,64,14,43,59,59,254,
010,53,85,96,76,83,62,455,
011,61,17,16,16,20,48,178,
012,49,10,81,13,39,86,278,
